0 1 1 1 1 1 1 1 1 1 1 1 1 1 1 2
3 4 4 4 4 4 4 4 4 4 4 4 4 4 4 5
3 4 4 4 4 4 4 4 4 4 4 4 9 4 4 5
3 4 4 4 4 4 4 4 4 4 4 4 4 4 4 5
3 4 4 4 4 4 4 4 4 4 4 4 4 4 4 5
3 4 4 4 4 4 4 4 4 4 4 10 4 4 4 5
3 4 4 4 4 4 4 4 4 4 4 4 4 4 4 5
3 4 4 4 4 4 4 4 4 4 4 4 4 4 4 5
3 4 4 4 4 4 4 4 4 4 4 4 11 4 4 5
3 4 4 4 4 4 4 4 4 4 4 4 4 4 4 5
3 4 4 4 4 4 4 4 4 4 4 4 4 4 4 5
6 7 7 7 7 7 7 7 7 7 7 7 7 7 7 8